000000000
010001110
010000010
011101110
000101000
000101110
000000000
